..................................................................................................................................................................................................................................................................................................
..................................................................................................................................................................................................................................................................................................
..................................................................................................................................................................................................................................................................................................
..................................................................................................................................................................................................................................................................##..............................
.................................................................................................................................................................................................................................................................###..............................
...............................................................................................................................................................................................................................................................#####..............................
..............................................................................................................................................................................................................................................................######..............................
....................########......................................................................................#################......................................................................####.......####.....................................#######..............................
...........................................................................................................................................................................................................................................................#########..............................
................###..........###............................................................................###........................................................................................####.......####...................................###########..............................
.@.....................................................................................................................................................................................................................................................#############..............................
======================================================...==============================================================..........============================================================================....=================================================================================